###################
#        #        #
#B## ### # ### ##B#
#                 #
# ## # ##### # ## #
#    #   #   #    #
#### ### # ### ####
#### #       # ####
#### # ##X## # ####
       #XXX#       
#### # ##### # ####
#### #       # ####
#### # ##### # ####
#        #        #
# ## ### # ### ## #
#B #           # B#
## # # ##### # # ##
#    #   #   #    #
# ###### # ###### #
#                 #
###################
